R 640 400
C      90,  1  ,  1
SO ../images/wood.xpm
NO             ../images/gold3d.xpm

S ../images/dragon.xpm

F   1  ,   90   ,  0
WE ../images/brick.xpm
EA ../images/metal.xpm

11111111111111111111111111111111111111111111111111111111111111111111111111111111111
10000000000000000000000000000000000000000000000000000000000000000000000000000000001
10202020202020202020202020202020202020202020202020202020202020202020202020202020201
10000000000000000000000000000000000000000000000000000000000000000000000000000000001
10202020202020202020202020202020202020202020202020202020202020202020202020202020201
10000000000000000000000000000000000000000000000000000000000000000000000000000000001
10202020202020202020202020202020202020202020202020202020202020202020202020202020201
10000000000000000000000000000000000000000000000000000000000000000000000000000000001
10202020202020202020202020202020202020202020202020202020202020202020202020202020201
10000000000000000000000000000000000000000000000000000000000000000000000000000000001
10202020202020202020202020202020202020202020202020202020202020202020202020202020201
10000000000000000000000000000000000000000000000000000000000000000000000000000000001
10202020202020202020202020202020202020202020202020202020202020202020202020202020201
10000000000000000000000000000000000000000000000000000000000000000000000000000000001
10202020202020202020202020202020202020202020202020202020202020202020202020202020201
10000000000000000000000000000000000000000000000000000000000000000000000000000000001
10202020202020202020202020202020202020202020202020202020202020202020202020202020201
10000000000000000000000000000000000000000000000000000000000000000000000000000000001
10202020202020202020202020202020202020202020202020202020202020202020202020202020201
10000000000000000000000000000000000000000000000000000000000000000000000000000000001
10202020202020202020202020202020202020202020202020202020202020202020202020202020201
10000000000000000000000000000000000000000000000000000000000000000000000000000000001
10202020202020202020202020202020202020202020202020202020202020202020202020202020201
10000000000000000000000000000000000000000000000000000000000000000000000000000000001
10202020202020202020202020202020202020202020202020202020202020202020202020202020201
10000000000000000000000000000000000000000000000000000000000000000000000000000000001
10202020202020202020202020202020202000000020202020202020202020202020202020202020201
10000000000000000000000000000000000000000000000000000000000000000000000000000000001
10202020202020202020202020202020202000E00020202020202020202020202020202020202020201
10000000000000000000000000000000000000000000000000000000000000000000000000000000001
10202020202020202020202020202020202000000020202020202020202020202020202020202020201
10000000000000000000000000000000000000000000000000000000000000000000000000000000001
10202020202020202020202020202020202020202020202020202020202020202020202020202020201
10000000000000000000000000000000000000000000000000000000000000000000000000000000001
10202020202020202020202020202020202020202020202020202020202020202020202020202020201
10000000000000000000000000000000000000000000000000000000000000000000000000000000001
10202020202020202020202020202020202020202020202020202020202020202020202020202020201
10000000000000000000000000000000000000000000000000000000000000000000000000000000001
10202020202020202020202020202020202020202020202020202020202020202020202020202020201
10000000000000000000000000000000000000000000000000000000000000000000000000000000001
10202020202020202020202020202020202020202020202020202020202020202020202020202020201
10000000000000000000000000000000000000000000000000000000000000000000000000000000001
10202020202020202020202020202020202020202020202020202020202020202020202020202020201
10000000000000000000000000000000000000000000000000000000000000000000000000000000001
10202020202020202020202020202020202020202020202020202020202020202020202020202020201
10000000000000000000000000000000000000000000000000000000000000000000000000000000001
10202020202020202020202020202020202020202020202020202020202020202020202020202020201
10000000000000000000000000000000000000000000000000000000000000000000000000000000001
10202020202020202020202020202020202020202020202020202020202020202020202020202020201
10000000000000000000000000000000000000000000000000000000000000000000000000000000001
10202020202020202020202020202020202020202020202020202020202020202020202020202020201
10000000000000000000000000000000000000000000000000000000000000000000000000000000001
10202020202020202020202020202020202020202020202020202020202020202020202020202020201
10000000000000000000000000000000000000000000000000000000000000000000000000000000001
10202020202020202020202020202020202020202020202020202020202020202020202020202020201
11111111111111111111111111111111111111111111111111111111111111111111111111111111111

